11111111111111111111111
1E1000C0010000C000C0001
10100101010101010010101
10100101010101010010101
1P001110C00C010000001C1
1010010101010101C010101
10110101010101010010101
1C100000C00C000000100C1
11111111111111111111111